WWWWWWWWWWWWWWWWWWWWWW
WOOOOOOOOOOOOOOOOOOOOW
WOOOOOOOOOOOOOOOOOOOOW
WOOSOOOOOOOOOOOOOOOOOW
WOOOOOOOOOOOOOOOOOOOOW
WOOOOOOOOOOOOOOOOOOOOW
WOOOOOOOOOOOOOOOOOOOOW
WOOOOOOOOOOOOOOOOOOOOW
WOOOOOOOOOOOOOOOOOOOOW
WOOOOOOOOOOOOOOOOOOOOW
WOOOOOOOOOOOOOOOOOOOOW
WOOOOOOOOOOOOOOOOOOOOW
WOOOOOOOOOOOOOOOOOOOOW
WOOOOOOOOOOOOOOOOOOOOW
WOOOOOOOOOOOOOOOOOOOOW
WOOOOOOOOOOOOOOOOOOOOW
WOOOOOOOOOOOOOOOOOOOOW
WOOOOOOOOOOOOOOOOOOOOW
WOOOOOOOOOOOOOOOOOOOOW
WOOOOOOOOOOOOOOOOOOGOW
WOOOOOOOOOOOOOOOOOOOOW
WWWWWWWWWWWWWWWWWWWWWW