WWWWWWWWWWWWWWWWWWWWWW
WOOOOOOOOOOOOOOOOOOOOW
WOOOWWWWWOOOWWWWOOOOOW
WOOSWOOOOOOOOOOWOOOOOW
WOOOWWWWWWWWWWWWOOOOOW
WOWWWOOOOOOOOOOOOOOOOW
WOWOOOOOOOOOOOOOOOOOOW
WOWOOOOOOOOOOWWWWWWWWW
WWWOOOOOOOOOOOOOOOOOOW
WOOOOOOOOOOOOOOOOOOOOW
WOOOOOOOOOOOOOOOOOOOOW
WOOOOOOOOWWWWWWWWWWWWW
WOOOOOOOOOOOOOOOOOOOOW
WOOOOOOOOOOOOOOOOOOOOW
WOOOOOOOOOOOOOOOOOOOOW
WOOOOOOOOOOOOOOOOWOOOW
WOOOOOOOOOOOOOOOOWOOOW
WOOOOOOOOOOOOOOOOWOOOW
WOOOOOOOOOOOOOOOOWOOOW
WOOOOOOOOOOOOOOOOWOGOW
WOOOOOOOOOOOOOOOOWOOOW
WWWWWWWWWWWWWWWWWWWWWW