WWWWWWWWWWWWWWWWWWWWWWWWWWWWWW
WSOOOOOOOOOOOOOOOOOOOOOOOOOOOW
WOWWWWWWWWWWWWWWWWWWWWWWWWWWOW
WOOOOOOOOOOOOWOOOOOOOOOOOOOOOW
WWWWWWWWWWWWOWWWWWWOWWWWWWWWWW
WOOOOOOOOOOOOOOOOOWOOOOOOOOOWW
WOWWWWWWWWWWWWWWWWWOWWWWWWWOOW
WOWWWWWWWWWWWWWWWWWOWWWWWWWWOW
WOOOOOOOOOOOOOOOOOOOWWWWWWWWOW
WWWWWWWWOWWWWWWWWWWWWOOOOOOWOW
WOOOOOOOOWWWWWWWWWWWWWWWOWWWOW
WOWWWWWWWWWWWGWWWWWWWWWWOWWWOW
WOOOOOOOOOOOWOOOOOOOOOOOOOOOOW
WWWWWWWWWWWWWWWWWWWWWWWWWWWWWW