WWWWWWWWWWWWWWWWWWWWWW
WOOOOOOOOOOOOOOOOOOOOW
WOOOOOOOOOOWOOOOOOOOOW
WOOOOOOOOOOWOOOOOGOOOW
WOOOOSOOOOOWWWWWOOOOOW
WOOOOOOOOOOOOOOWOOOOOW
WOWWWWWWWWWWOOOWOOOOOW
WOOOOOOOOOOWOOOWOOOOOW
WOOOOOOOOOOWOOOWOOOOOW
WOOOOOOOOOOWOOOWOOOOOW
WOOOOOOOOOOWWWWWOOOOOW
WOOOOOOOOOOOOOOOOOOOOW
WOOOOOOOOOOOOOOOOOOOOW
WOOOOOOOOOOOOOOOOOOOOW
WOOOOOOOOOOOOOOOOOOOOW
WOOOOOOOOOWWOOOOOOOOOW
WOOOOWWWWWWWWWWWOOOOOW
WOOOOOOWWOOOOOOOOOOOOW
WOOOOOOOOOOOOOOOOOOOOW
WOOOOOOOOOOOOOOOOOOWOW
WOOOOOOOOOOOOOOOOOOOOW
WWWWWWWWWWWWWWWWWWWWWW